0S0000000000000000''
000000000000000000CC
00000''HHH''000000CC
00000''HHH''000000''
00000''HHH''000000CC
00000''HHH''000000CC
00000''HHH''000000''
00000''HHH''000000CC
000000000000000000CC
EE0000000000000000''